0,0,0,0,0,0,0,0,0,0,0,0,0,0,0
0,15,0,22,0,18,0,1,0,12,0,23,0,11,0
0,0,0,0,0,0,0,1,0,0,0,0,0,0,0
0,24,0,43,0,12,0,45,0,14,0,41,0,24,0
0,0,0,0,0,0,0,1,0,0,0,0,0,0,0
0,16,0,13,0,19,0,1,0,18,0,13,0,12,0
0,0,0,0,0,0,0,1,0,0,0,0,0,0,0
0,1,1,46,1,1,1,1,1,1,1,46,1,1,0
0,0,0,0,0,0,0,1,0,0,0,0,0,0,0
0,12,0,19,0,12,0,1,0,18,0,15,0,12,0
0,0,0,0,0,0,0,1,0,0,0,0,0,0,0
0,24,0,42,0,14,0,45,0,15,0,44,0,21,0
0,0,0,0,0,0,0,1,0,0,0,0,0,0,0
0,11,0,23,0,12,0,1,0,16,0,21,0,11,0
0,0,0,0,0,0,0,99,0,0,0,0,0,0,0
