1,1,1,1,1,1,1,1,1,1
1,0,0,0,1,0,0,0,0,1
1,0,11,0,1,0,1,1,0,1
1,0,21,0,0,0,0,1,0,1
1,0,12,1,1,1,0,1,0,1
1,0,25,0,0,1,0,0,0,1
1,1,1,1,0,1,1,1,0,1
1,0,13,0,0,0,0,1,0,1
1,0,1,1,1,1,0,0,0,1
1,1,1,1,1,1,1,1,1,1
