1,1,1,1,1,1,1,1,1,1
1,0,0,0,0,0,0,0,0,1
1,0,11,0,0,0,0,0,0,1
1,0,21,0,0,0,0,0,0,1
1,0,35,0,0,0,0,0,0,1
1,0,41,0,0,0,0,0,0,1
1,0,0,0,0,0,0,0,0,1
1,0,12,0,0,0,0,0,0,1
1,0,0,0,0,0,0,0,0,1
1,1,1,1,1,1,1,1,1,1
