1,1,1,1,1,1,1,1,1,1
1,0,0,0,0,0,0,0,0,1
1,0,31,0,0,0,0,0,0,1
1,0,26,0,0,0,0,0,0,1
1,0,12,0,0,0,0,0,0,1
1,0,41,0,0,0,0,0,0,1
1,0,0,0,0,0,0,0,0,1
1,0,11,0,0,0,0,0,0,1
1,0,0,0,0,0,0,0,0,1
1,1,1,1,1,1,1,1,1,1
